1111111111111
0P01L000000C1
100001111001
1P00110000001
1111111111111
