1111111111111111111111111111111111
1E000001000V000C00000C0V0000000001
10100101001000001V1001001111110101
1010010010101010001001000000010101
1P0000000C10C000V0100000V100C100C1
1111111111111111111111111111111111
