1111111111111111111
10P10000000V00000C1
1001010010011111111
1011011010000V00001
1000000011111111101
1011111110000C00001
1000000010111111111
1V11111000000000001
1010000000011111001
1E1C000000V1C0E0001
1111111111111111111
